        ########
        #.....@#
        #.C#C.##
        #.C..C#
        ##C.C.#
#########.C#..###
#TTTT..##.C..C..#
##TTT....C..C...#
#TTTT...#########
#########
