##########
#....T...#
#..C##...#
#..C.T...#
###@.#...#
#....C...#
#....T...#
##########
