    #####
    #...#
    #C..#
  ###..C##
  #..C.C.#
###.#.##.#    #######
#...#.##.######.TT..#
#.C..C............TT#
#####.###.#@##..TT..#
    #.....###########
    #######
