############
#TT..#.....###
#TT..#.C..C..#
#TT..#C####..#
#TT....@.##..#
#TT..#.#..C.##
######.##C.C.#
  #.C..C.C.C.#
  #....#.....#
  ############